71983W
55
###############
#             #
#   # @A@ #   #
#  @      @@  #
#   @         #
#   #     #   #
#             #
###############
