8 15
###############
#D         G  #
#  D#     #   #
#      A  @  D#
#   @         #
#G  #     #  D#
# G         G #
###############